####################
....................
..1.......X.........
.......######.......
..G..............G..
####..G.G.G.G....###
.......G.G.GCG......
......--------......
...--...........--..
..........A.........
.G.G............G.G.
####............####
....................
....................
####################
